88 12
0 1 2 0 0 1 2 0 0 1 3 0 0 1 2 0 4 1 2 4 0 0 0 0 1 2 5 1 6 0 0 4 1 4 1 4 1 4 1 0 4 0 6 6 0 5 1 7 8 9 9 1 9 9 9 9 10 9 10 9 9 9 9 11 0 0 1 6 0 1 4 0 1 2 12 13 0 14 1 13 0 14 1 13 0 3 4 15 
16 17 18 19 20 17 18 19 20 17 21 19 20 17 18 19 16 17 18 22 20 20 20 20 17 23 22 17 20 20 20 16 17 22 17 22 17 22 17 20 22 20 20 20 20 22 17 24 25 26 27 28 27 29 29 29 28 26 17 27 27 29 29 24 20 16 17 20 20 17 22 20 17 18 16 20 30 31 17 32 30 31 17 32 30 21 22 33 
20 17 23 22 20 17 18 22 20 17 18 22 20 17 18 22 20 17 18 22 20 20 34 35 36 37 38 38 39 40 20 20 17 22 17 22 17 22 17 19 22 20 34 35 38 37 36 41 42 43 43 36 27 27 44 44 17 44 17 27 26 43 43 41 37 38 38 39 40 17 22 20 17 23 20 20 17 20 17 20 17 20 17 19 17 23 22 24 
20 17 20 22 20 17 23 22 19 17 18 22 20 17 23 22 20 17 18 22 34 35 45 46 17 20 16 17 47 48 37 49 17 22 17 22 17 22 17 16 22 34 50 46 20 20 30 33 51 44 44 17 43 52 53 44 54 54 55 43 52 53 26 56 21 20 30 47 48 38 37 38 38 39 40 20 17 20 17 20 17 20 17 16 17 34 35 41 
20 17 20 22 19 17 20 22 16 17 23 22 20 17 20 22 16 17 23 34 57 46 19 20 17 20 20 17 20 17 19 19 17 22 17 22 17 22 17 19 34 50 46 19 20 20 17 33 51 27 27 28 44 17 58 53 59 60 28 44 17 58 53 56 23 20 17 20 19 17 16 17 16 47 61 40 17 20 17 20 17 20 17 20 17 62 46 33 
37 36 37 37 37 36 37 37 37 36 37 37 37 36 37 37 37 36 37 63 37 37 37 37 36 37 37 36 37 36 37 37 36 37 36 37 36 37 36 37 63 37 37 37 37 37 36 64 65 66 43 36 43 36 67 68 69 70 36 52 36 67 68 71 37 37 36 37 37 36 37 36 37 37 37 48 36 37 36 37 36 37 36 37 36 37 37 64 
72 72 72 72 72 72 72 72 72 72 72 72 72 72 72 72 72 72 72 72 72 72 72 72 72 72 72 72 72 72 72 72 72 72 72 72 72 72 72 72 72 72 72 72 72 72 72 72 73 74 75 73 72 72 73 72 73 72 1 74 75 72 1 76 72 72 72 72 72 72 72 72 72 72 72 72 72 72 72 72 72 72 72 72 72 72 72 72 
72 72 72 72 72 72 72 72 72 72 72 72 72 72 72 72 72 72 72 72 72 72 72 72 72 72 72 72 72 72 72 72 72 72 72 72 72 72 72 72 72 72 72 72 72 72 72 72 17 27 77 28 72 72 28 72 17 72 17 27 78 75 17 56 72 72 72 72 72 72 72 72 72 72 72 72 72 72 72 72 72 72 72 72 72 72 72 72 
72 72 72 72 72 72 72 72 72 72 72 72 72 72 72 72 72 72 72 72 72 72 72 72 72 72 72 72 72 72 72 72 72 72 72 72 72 72 72 72 72 72 72 72 72 72 72 72 28 27 27 79 72 72 28 72 17 72 17 27 27 77 17 56 72 72 72 72 72 72 72 72 72 72 72 72 72 72 72 72 72 72 72 72 72 72 72 72 
72 72 72 72 72 72 72 72 72 72 72 72 72 72 72 72 72 72 72 72 72 72 72 72 72 72 72 72 72 72 72 72 72 72 72 72 72 72 72 72 72 72 72 72 72 72 72 72 55 80 80 55 81 80 55 72 55 72 55 80 80 80 82 56 72 72 72 72 72 72 72 72 72 72 72 72 72 72 72 72 72 72 72 72 72 72 72 72 
72 72 72 72 72 72 72 72 72 72 72 72 72 72 72 72 72 72 72 72 72 72 72 72 72 72 72 72 72 72 72 72 72 72 72 72 72 72 72 72 72 72 72 72 72 72 72 72 28 72 72 28 83 84 17 85 17 85 17 84 85 72 17 80 72 72 72 72 72 72 72 72 72 72 72 72 72 72 72 72 72 72 72 72 72 72 72 72 
72 72 72 72 72 72 72 72 72 72 72 72 72 72 72 72 72 72 72 72 72 72 72 72 72 72 72 72 72 72 72 72 72 72 72 72 72 72 72 72 72 72 72 72 72 72 72 72 86 86 86 86 86 86 86 86 86 86 86 86 86 86 55 86 72 72 72 72 72 72 72 72 72 72 72 72 72 72 72 72 72 72 72 72 72 72 72 72 